NO ./path_to_the_north_texture
SO ./path_to_the_south_texture
WE ./path_to_the_west_texture
EA ./path_to_the_east_texture
F 220,100,0
C 225,30,0
        1111111111111111111111111
        1000000000110000000000001
        1011000001110100000000001
        10010000000010100000000001
111111111011000001110100000000001
1000000000110000011101111111111111
11110111111111011100000010001
11111111111111011111111111111
11000000110101011100000010001
1000000000000000111000010001
100000000000000011S1010010001
11000001110101011111011110001111
11111111 1111111 111111111111