NO ./textures/wall.png
SO ./textures/wall.png
WE ./textures/color.png
EA ./textures/wall.png
F 53,104,45
C 0,170,228
         1111111111111111111111111
         1000000000110000000000001
         1011000001100000000000001
         101000000000000000000001
111111111011000001110000000000001
100000000011000001110011111111111
11110111111111011100000010001
11110111111111011101010010001
11000000110101011100000011001
10000000000000001100000000101
10000000000000000000000010101
1100000111010101111011111W111
11110111 1110101 101111010101
11111111 1111111 111111111111